Abrothallus	lichenicolous
Absconditella	lichen
Acanthothecis	lichen
Acaroconium	lichenicolous
Acarospora	lichen
Acremonium	lichenicolous
Acrocordia	lichen
Acroscyphus	lichen
Actinogyra	lichen
Adelococcus	lichenicolous
Adelolecia	lichen
Agonimia	lichen
Agrestia	lichen
Agyrium	lichen_ally
Agyrophora	lichen
Ahlesia	lichen
Ahtiana	lichen
Alectoria	lichen
Allantoparmelia	lichen
Allarthonia	lichen
Allocetraria	lichen
Alyxoria	lichen
Amandinea	lichen
Ameliella	lichen
Ameroconium	lichenicolous
Amphiloma	lichen
Amygdalaria	lichen
Anamylopsora	lichen
Anaptychia	lichen
Andreiomyces	lichen
Anema	lichen
Anisomeridium	lichen
Anomalobaria	lichen
Anomomorpha	lichen
Anthracothecium	lichen
Anzia	lichen
Anzina	lichen
Apatoplaca	lichen
Arctocetraria	lichen
Arctomia	lichen
Arctoparmelia	lichen
Arctopeltis	lichen
Arthonia	lichen
Arthophacopsis	lichenicolous
Arthopyrenia	lichen
Arthotheliopsis	lichen
Arthothelium	lichen
Arthrorhaphis	lichen
Arthrosporum	lichen
Asahinea	lichen
Aspicilia	lichen
Aspidothelium	lichen
Aspilidea	lichen
Asterophoma	lichenicolous
Asterothyrium	lichen
Astrothelium	lichen
Athallia	lichen
Aulaxina	lichen
Bachmanniomyces	lichenicolous
Bacidia	lichen
Bacidina	lichen
Bactrospora	lichen
Baculifera	lichen
Baeomyces	lichen
Bagliettoa	lichen
Bathelium	lichen
Bellemerea	lichen
Bellemerella	lichenicolous
Belonia	lichen
Biatora	lichen
Biatorella	lichen
Biatoridium	lichen
Biatoropsis	lichenicolous
Bilimbia	lichen
Bispora	lichenicolous
Blastenia	lichen
Blennothallia	lichen
Bombyliospora	lichen
Botrydina	lichen
Botryolepraria	lichen
Bottaria	lichen
Briancoppinsia	lichenicolous
Brigantiaea	lichen
Brodoa	lichen
Brucea	lichen_ally
Bruceomyces	lichen_ally
Bryobilimbia	lichen
Bryocaulon	lichen
Bryodina	lichen
Bryonora	lichen
Bryophagus	lichen
Bryoplaca	lichen
Bryopogon	lichen
Bryoria	lichen
Bryoscyphus	lichenicolous
Bryostigma	lichen
Buellia	lichen
Buelliella	lichenicolous
Buelliopsis	lichen
Bulbothrix	lichen
Bullatina	lichen
Bunodophoron	lichen
Burgella	lichenicolous
Byssoloma	lichen
Caeruleum	lichen
Calenia	lichen
Caliciella	lichen
Calicium	lichen
Callome	lichen
Calogaya	lichen
Calopadia	lichen
Caloplaca	lichen
Caloplacopsis	lichen
Calvitimela	lichen
Campylothelium	lichen
Candelaria	lichen
Candelariella	lichen
Candelina	lichen
Canomaculina	lichen
Canoparmelia	lichen
Capronia	lichenicolous
Carbacanthographis	lichen
Carbonea	lichen
Carbonicola	lichen
Catapyrenium	lichen
Catillaria	lichen
Catillochroma	lichen
Catinaria	lichen
Catolechia	lichen
Cavernularia	lichen
Cecidonia	lichenicolous
Celidium	lichenicolous
Celothelium	lichen
Cephalophysis	lichen
Cercidospora	lichenicolous
Cerothallia	lichen
Cetradonia	lichen
Cetraria	lichen
Cetrariastrum	lichen
Cetrariella	lichen
Cetrelia	lichen
Chaenotheca	lichen
Chaenothecopsis	lichen_ally
Chalara	lichenicolous
Chapsa	lichen
Cheiromycina	lichen
Chiodecton	lichen
Chionosphaera	lichenicolous
Chrismofulvea	lichen
Chromatochlamys	lichen
Chrysopsora	lichen
Chrysothrix	lichen
Ciposia	lichen
Circinaria	lichen
Cladidium	lichen
Cladina	lichen
Cladonia	lichen
Cladophialophora	lichenicolous
Clathroporina	lichen
Claurouxia	lichen
Clauzadea	lichen
Clauzadeana	lichen
Clavascidium	lichen
Cliostomum	lichen
Clypeococcum	lichenicolous
Coccocarpia	lichen
Coccotrema	lichen
Coelocaulon	lichen
Coenogonium	lichen
Collema	lichen
Collemodes	lichen
Collemopsidium	lichen
Collemopsis	lichen
Combea	lichen
Coniambigua	lichenicolous
Coniarthonia	lichen
Coniocybe	lichen
Coniocybopsis	lichen_ally
Conotrema	lichen
Cora	basidiolichen
Coriscium	lichen
Cornicularia	lichen
Cornutispora	lichenicolous
Corticifraga	lichenicolous
Cratiria	lichen
Crespoa	lichen
Cresponea	lichen
Crocodia	lichen
Crocynia	lichen
Cryptolechia	lichen
Cryptothecia	lichen
Cryptothele	lichen
Culbersonia	lichen
Cybebe	lichen
Cypheliopsis	lichen
Cyphelium	lichen
Cyrtidula	lichen
Cystobasidium	lichenicolous
Cystocoleus	lichen
Dacampia	lichenicolous
Dactylina	lichen
Dactylospora	lichenicolous
Degelia	lichen
Dendriscocaulon	lichen
Dendriscosticta	lichen
Dendrodochium	lichenicolous
Dendrographa	lichen
Dermatina	lichen
Dermatiscum	lichen
Dermatocarpon	lichen
Dermiscellum	lichen
Desmazieria	lichen
Dibaeis	lichen
Dictyocatenulata	lichen
Dictyonema	lichen
Didymellopsis	lichenicolous
Didymosphaeria	lichenicolous
Digitothyrea	lichen
Dimelaena	lichen
Dimerella	lichen
Dimidiographa	lichen
Dinemasporium	lichenicolous
Diorygma	lichen
Diplodina	lichen
Diploicia	lichen
Diplolaeviopsis	lichenicolous
Diploschistella	lichen
Diploschistes	lichen
Diplotomma	lichen
Dirina	lichen
Dirinaria	lichen
Discothecium	lichenicolous
Distopyrenis	lichen
Ditremis	lichen
Dufourea	lichen
Dyplolabia	lichen
Echinodiscus	lichenicolous
Echinoplaca	lichen
Echinothecium	lichenicolous
Edrudia	lichen
Eiglera	lichen
Elixia	lichen
Enchylium	lichen
Endocarpon	lichen
Endococcus	lichenicolous
Endohyalina	lichen
Endopyrenium	lichen
Enterographa	lichen
Enterostigma	lichen
Eopyrenula	lichen
Epaphroconidia	lichenicolous
Ephebe	lichen
Ephebeia	lichen
Epicladonia	lichenicolous
Epicoccum	lichenicolous
Epigloea	lichen
Epilichen	lichenicolous
Epithamnolia	lichenicolous
Erioderma	lichen
Esslingeriana	lichen
Eugeniella	lichen
Euopsis	lichen
Evernia	lichen
Everniastrum	lichen
Everniicola	lichenicolous
Farnoldia	lichen
Fellhanera	lichen
Fellhaneropsis	lichen
Fibrillithecis	lichen
Fissurina	lichen
Fistulariella	lichen
Flakea	lichen
Flavocetraria	lichen
Flavoparmelia	lichen
Flavoplaca	lichen
Flavopunctelia	lichen
Foraminella	lichen
Forssellia	lichen
Frutidella	lichen
Fulgensia	lichen
Fulgidea	lichen
Fulvophyton	lichen
Fusarium	lichenicolous
Fuscidea	lichen
Fuscopannaria	lichen
Gasparrinia	lichen
Gassicurtia	lichen
Geisleria	lichen
Gelatinopsis	lichenicolous
Geltingia	lichenicolous
Glaucomaria	lichen
Glaucotrema	lichen
Globosphaeria	lichenicolous
Gloeoheppia	lichen
Glyphis	lichen
Glypholecia	lichen
Gomphillus	lichen
Gongylia	lichen
Gonohymenia	lichen
Gowardia	lichen
Granulopyrenis	lichen
Graphina	lichen
Graphis	lichen
Graphium	lichenicolous
Gyalecta	lichen
Gyalectaria	lichen
Gyalectidium	lichen
Gyalectina	lichen
Gyalidea	lichen
Gyalideopsis	lichen
Gyalolechia	lichen
Gymnoderma	lichen
Gypsoplaca	lichen
Gyrophora	lichen
Gyrostomum	lichen
Haematomma	lichen
Hafellia	lichen
Hafellnera	lichen
Halecania	lichen
Halegrapha	lichen
Halospora	lichenicolous
Harpidium	lichen
Hassea	lichenicolous
Hawksworthiana	lichenicolous
Heiomasia	lichen
Helminthocarpon	lichen
Helocarpon	lichen
Henrica	lichen
Heppia	lichen
Herpothallon	lichen
Herteliana	lichen
Hertelidea	lichen
Heterocarpon	lichenicolous
Heterocyphelium	lichen
Heterodermia	lichen
Heteroplacidium	lichen
Heterothecium	lichen
Hobsonia	lichenicolous
Hobsoniopsis	lichenicolous
Homostegia	lichenicolous
Hubbsia	lichen
Huilia	lichen
Hyalopeziza	lichenicolous
Hydropunctaria	lichen
Hydrothyria	lichen
Hymenelia	lichen
Hyperphyscia	lichen
Hypocenomyce	lichen
Hypogymnia	lichen
Hypotrachyna	lichen
Icmadophila	lichen
Illosporiopsis	lichenicolous
Illosporium	lichenicolous
Immersaria	lichen
Imshaugia	lichen
Ingvariella	lichen
Intralichen	lichenicolous
Involucropyrenium	lichen
Ionaspis	lichen
Jamesiella	lichen
Japewia	lichen
Jarxia	lichen
Julella	lichen_ally
Kaernefeltia	lichen
Kalchbrenneriella	lichenicolous
Karschia	lichenicolous
Karsteniomyces	lichenicolous
Kephartia	lichen
Kiliasia	lichen
Kirschsteiniothelia	lichenicolous
Koerberia	lichen
Koerberiella	lichen
Kohlmeyera	lichen
Laeviomyces	lichenicolous
Lahmia	lichenicolous
Lasallia	lichen
Lasiosphaeriopsis	lichenicolous
Lathagrium	lichen
Lauderlindsaya	lichenicolous
Laurera	lichen
Lecanactis	lichen
Lecania	lichen
Lecanographa	lichen
Lecanora	lichen
Lecanoropsis	lichen
Lecidea	lichen
Lecidella	lichen
Lecidoma	lichen
Leciographa	lichenicolous
Leciophysma	lichen
Leightoniomyces	lichenicolous
Leimonis	lichen
Leioderma	lichen
Leiorreuma	lichen
Lemmopsis	lichen
Lempholemma	lichen
Lepidoma	lichen
Lepraria	lichen
Leprocaulon	lichen
Leprocollema	lichen
Leproloma	lichen
Leproplaca	lichen
Leptochidium	lichen
Leptogidium	lichen
Leptogium	lichen
Leptorhaphis	lichen
Leptosphaerulina	lichenicolous
Leptotrema	lichen
Letharia	lichen
Lethariicola	lichenicolous
Letrouitia	lichen
Lettauia	lichenicolous
Leucocarpia	lichen
Leucodecton	lichen
Leucogyrophana	lichenicolous
Lichenochora	lichenicolous
Lichenoconium	lichenicolous
Lichenodiplis	lichenicolous
Lichenomphalia	basidiolichen
Lichenopeltella	lichenicolous
Lichenopuccinia	lichenicolous
Lichenosticta	lichenicolous
Lichenostigma	lichenicolous
Lichenothelia	lichen_ally
Lichenothrix	lichen
Lichina	lichen
Lichinella	lichen
Lichinodium	lichen
Lignoscripta	lichen
Lithographa	lichen
Lithothelium	lichen
Llimonaea	lichen
Llimoniella	lichenicolous
Lobaria	lichen
Lobothallia	lichen
Lopadiopsis	lichen
Lopadium	lichen
Lopezaria	lichen
Lophiostoma	lichen_ally
Loxospora	lichen
Loxosporopsis	lichen
Macentina	lichen
Malcolmiella	lichen
Malmidea	lichen
Marchandiobasidium	basidiolichen
Marchandiomyces	lichenicolous
Maronea	lichen
Masonhalea	lichen
Massalongia	lichen
Mastodia	lichen
Mazosia	lichen
Medusulina	lichen
Megalaria	lichen
Megalospora	lichen
Megaspora	lichen
Melanaria	lichen
Melanelia	lichen
Melanelixia	lichen
Melanohalea	lichen
Melanolecia	lichen
Melanomma	lichen_ally
Melanophloea	lichen
Melanotheca	lichen
Melanotopelia	lichen
Melanotrema	lichen
Melaspilea	lichen
Menegazzia	lichen
Merismatium	lichenicolous
Metamelanea	lichen
Metasphaeria	lichenicolous
Micarea	lichen
Micareopis	lichen
Microcalicium	lichenicolous
Microglaena	lichen
Microlychnus	lichen
Microphiale	lichen
Microthelia	lichen_ally
Minutoexcipula	lichenicolous
Miriquidica	lichen
Mobergia	lichen
Moelleropsis	lichen
Monoblastia	lichen
Monoblastiopsis	lichen
Monodictys	lichenicolous
Montanelia	lichen
Mosigia	lichen
Muellerella	lichenicolous
Multiclavula	lichen_ally
Mycobilimbia	lichen
Mycoblastus	lichen
Mycocalicium	lichen_ally
Mycoglaena	lichen_ally
Mycomicrothelia	lichen_ally
Mycoporellum	lichen
Mycoporum	lichen
Myelochroa	lichen
Myochroidea	lichen
Myrionora	lichen
Myriospora	lichen
Myriotrema	lichen
Myxobilimbia	lichen
Myxophora	lichen_ally
Myxotrichum	lichen
Nadvornikia	lichen
Naetrocymbe	lichen
Nanostictis	lichenicolous
Nectriella	lichenicolous
Nectriopsis	lichenicolous
Neobarya	lichenicolous
Neocatapyrenium	lichen
Neocoleroa	lichenicolous
Neofuscelia	lichen
Neolamya	lichenicolous
Nephroma	lichen
Nesolechia	lichenicolous
Neuropogon	lichen
Niebla	lichen
Niesslia	lichenicolous
Nigropuncta	lichenicolous
Nodobryoria	lichen
Normandina	lichen
Obryzum	lichenicolous
Ocellularia	lichen
Ochrolechia	lichen
Odontotrema	lichenicolous
Omphalaria	lichen
Omphalina	lichen
Omphalodiscus	lichen
Omphalodium	lichen
Omphalora	lichen
Opegrapha	lichen
Opegraphoidea	lichenicolous
Ophioparma	lichen
Orcularia	lichen
Orphniospora	lichen
Ovicuculispora	lichen
Oxneria	lichen
Pachyospora	lichen
Pachypeltis	lichen
Pachyphiale	lichen
Pachyphysis	lichen
Pannaria	lichen
Paranectria	lichenicolous
Paraparmelia	lichen
Paraschismatomma	lichen
Parathelium	lichen
Parmelia	lichen
Parmeliella	lichen
Parmelina	lichen
Parmelinopsis	lichen
Parmeliopsis	lichen
Parmentaria	lichen
Parmotrema	lichen
Parmotremopsis	lichen
Parmularia	lichen
Parvoplaca	lichen
Patriciomyces	lichen
Paulia	lichen
Peccania	lichen
Peltigera	lichen
Peltula	lichen
Perforaria	lichen
Peridiothelia	lichen_ally
Perigrapha	lichenicolous
Pertusaria	lichen
Petractis	lichen
Pezizella	lichenicolous
Phacographa	lichenicolous
Phacopsis	lichenicolous
Phacothecium	lichenicolous
Phaeocalicium	lichen_ally
Phaeographina	lichen
Phaeographis	lichen
Phaeophyscia	lichen
Phaeopyxis	lichenicolous
Phaeorrhiza	lichen
Phaeospora	lichenicolous
Phaeosporobolus	lichenicolous
Phaeotrema	lichen
Pharcidia	lichenicolous
Phloeopeccania	lichen
Phlyctella	lichen
Phlyctidia	lichen
Phlyctis	lichen
Phoebus	lichen
Phoma	lichenicolous
Phragmonaevia	lichenicolous
Phylliscum	lichen
Phyllopsora	lichen
Physalospora	lichenicolous
Physcia	lichen
Physciella	lichen
Physciopsis	lichen
Physconia	lichen
Physma	lichen
Phytoconis	lichen
Piccolia	lichen
Pilophorus	lichen
Placidiopsis	lichen
Placidium	lichen
Placocarpus	lichenicolous
Placodium	lichen
Placomaronea	lichen
Placopsis	lichen
Placopyrenium	lichen
Placynthiella	lichen
Placynthium	lichen
Plagiocarpa	lichen
Platismatia	lichen
Platygramme	lichen
Platygrapha	lichen
Platygraphopsis	lichen
Platythecium	lichen
Plectocarpon	lichenicolous
Pleopsidium	lichen
Pleurotheliopsis	lichen
Pleurotrema	lichen
Poeltinula	lichen
Polyblastia	lichen
Polyblastiopsis	lichen
Polycauliona	lichen
Polychidium	lichen
Polycoccum	lichenicolous
Polydesmia	lichenicolous
Polymeridium	lichen
Polypyrenula	lichen
Polysporina	lichen
Polythelis	lichen
Porina	lichen
Porocyphus	lichen
Porpidia	lichen
Pronectria	lichenicolous
Protoblastenia	lichen
Protomicarea	lichen
Protopannaria	lichen
Protoparmelia	lichen
Protoparmeliopsis	lichen
Protothelenella	lichen
Pseudephebe	lichen
Pseudevernia	lichen
Pseudocyphellaria	lichen
Pseudoparmelia	lichen
Pseudopyrenula	lichen
Pseudosagedia	lichen
Psilolechia	lichen
Psora	lichen
Psorinia	lichen
Psoroglaena	lichen
Psoroma	lichen
Psorotichia	lichen
Psorula	lichen
Pterygiopsis	lichen
Pterygium	lichen
Ptychographa	lichen
Punctelia	lichen
Puttea	lichen
Pycnora	lichen
Pycnothelia	lichen
Pyrenastrum	lichen
Pyrenidium	lichenicolous
Pyrenocollema	lichen
Pyrenodesmia	lichen
Pyrenopsidium	lichen
Pyrenopsis	lichen
Pyrenothamnia	lichen
Pyrenothrix	lichen
Pyrenotrichum	lichen
Pyrenula	lichen
Pyrenulella	lichenicolous
Pyrgillus	lichen
Pyrrhospora	lichen
Pyxine	lichen
Raciborskiomyces	lichenicolous
Racodium	lichen
Ramalina	lichen
Ramboldia	lichen
Ramonia	lichen
Rechingeria	lichen
Reconditella	lichenicolous
Refractohilum	lichenicolous
Reimnitzia	lichen
Reinkella	lichen
Relicina	lichen
Requienella	lichen
Rhabdospora	lichen
Rhagadostoma	lichenicolous
Rhizocarpon	lichen
Rhizoplaca	lichen
Rhymbocarpus	lichenicolous
Rimelia	lichen
Rimeliella	lichen
Rimularia	lichen
Rinodina	lichen
Robergea	lichen
Roccella	lichen
Roccellina	lichen
Romjularia	lichen
Ropalospora	lichen
Roselliniella	lichenicolous
Roselliniopsis	lichenicolous
Rosellinula	lichenicolous
Saccomorpha	lichen
Sagedia	lichen
Sagediopsis	lichenicolous
Sagiolechia	lichen
Santessoniella	lichen
Sarcographa	lichen
Sarcogyne	lichen
Sarcopyrenia	lichenicolous
Sarcosagium	lichen
Sarea	lichen_ally
Schadonia	lichen
Schaereria	lichen
Schismatomma	lichen
Schizopelte	lichen
Sclerococcum	lichenicolous
Sclerophora	lichen
Sclerophyton	lichen
Scoliciosporum	lichen
Sculptolumina	lichen
Scutula	lichenicolous
Secoliga	lichen
Segestria	lichen
Seirophora	lichen
Sigridea	lichen
Silobia	lichen
Siphula	lichen
Skyttea	lichenicolous
Skyttella	lichenicolous
Solenopsora	lichen
Solorina	lichen
Solorinaria	lichen
Solorinella	lichen
Speerschneidera	lichen
Sphaerellothecium	lichenicolous
Sphaeria	lichen
Sphaerophorus	lichen
Sphaerulina	lichenicolous
Sphinctrina	lichenicolous
Sphinctrinella	lichen_ally
Spilonema	lichen
Spilonemella	lichen
Spirographa	lichenicolous
Sporastatia	lichen
Sporodictyon	lichen
Sporopodium	lichen
Sporostigma	lichen
Squamarina	lichen
Staurolemma	lichen
Staurothele	lichen
Stegobolus	lichen
Steineropsis	lichen
Steinia	lichen
Stenocybe	lichen_ally
Stereocaulon	lichen
Sticta	lichen
Stictis	lichen
Stigmidium	lichenicolous
Stirtonia	lichen
Strangospora	lichen
Strigula	lichen
Stromatella	lichen
Sulcaria	lichen
Sulcopyrenula	lichen
Synalissa	lichen
Syncesia	lichen
Synechoblastus	lichen
Syzygospora	lichenicolous
Szczawinskia	lichen
Taeniolella	lichenicolous
Talpapellis	lichenicolous
Tapellaria	lichen
Teloschistes	lichen
Tephromela	lichen
Tetramelas	lichen
Texosporium	lichen
Thalloloma	lichen
Thamnogalla	lichenicolous
Thamnolia	lichen
Thecaria	lichen
Thelenella	lichen
Thelidiella	lichen
Thelidium	lichen
Thelignya	lichen
Thelocarpon	lichen
Thelomma	lichen
Thelopsis	lichen
Thelotrema	lichen
Thermutis	lichen
Tholurna	lichen
Thrombium	lichen
Thyrea	lichen
Tichothecium	lichenicolous
Tomasellia	lichen
Toninia	lichen
Topelia	lichen
Topeliopsis	lichen
Tornabea	lichen
Trapelia	lichen
Trapeliopsis	lichen
Trematosphaeriopsis	lichenicolous
Tremolecia	lichen
Tricharia	lichen
Trichonectria	lichenicolous
Trichoramalina	lichen
Trichosphaeria	lichenicolous
Trichothelium	lichen
Trimmatothele	lichen
Trypethelium	lichen
Tuckermanella	lichen
Tuckermannopsis	lichen
Turgidosculum	lichen
Tylophoron	lichen
Tylothallia	lichen
Umbilicaria	lichen
Unguiculariopsis	lichenicolous
Urceolaria	lichen
Usnea	lichen
Usnocetraria	lichen
Vahliella	lichen
Vainionora	lichen
Varicellaria	lichen
Vermilacinia	lichen
Verrucaria	lichen
Vestergrenopsis	lichen
Vezdaea	lichen
Vouauxiella	lichenicolous
Vouauxiomyces	lichenicolous
Vulpicida	lichen
Wahlenbergiella	lichen
Waynea	lichen
Weddellomyces	lichenicolous
Wentiomyces	lichenicolous
Xanthomendoza	lichen
Xanthoparmelia	lichen
Xanthopsora	lichen
Xanthopsorella	lichen
Xanthoria	lichen
Xenonectriella	lichenicolous
Xerotrema	lichen_ally
Xyleborus	lichen
Xylographa	lichen
Xyloschistes	lichen
Zahlbrucknerella	lichen
Zamenhofia	lichen
Zwackhiomyces	lichenicolous
